111111111
100000P11
1C000E011
100000001
100000001
100000001
111111111