1111111111111111111111
10000000000000000000C1
1000000000000100000011
1000000000000000000001
100100C010100000C000C1
1000000100010000011111
10000000000000010E0001
1000010000000000000001
111C10CC00000000100011
100000000000000C000001
1000000000001000000011
1000000C000P0000000001
1111111111111111111111