1111111111
100000P011
1C00000011
100E000011
1000000011
1111111111